##############################
#                            #
# #### ##### ## ##### #### # #
# #### ##### ## ##### #### # #
#                            #
# #### ## ######## ## #### # #
# #### ## ######## ## #### # #
#      ##    ##    ##      # #
# #### ##### ## ##### ###### #
# #### ##### ## ##### ###### #
# #### ##          ## ###### #
# #### ## ###  ### ## ###### #
# #### ## #      # ## ###### #
#         #      #           #
# #### ## ######## ## ###### #
# #### ##          ## ###### #
# #### ## ######## ## ###### #
#         ######         # # #
# ## ### ##      ## ### ## # #
#    #      ######      #    #
### ## ## ######## ## ## ### #
#                            #
# #### ##### ## ##### #### # #
# #### ##### ## ##### #### # #
#                            #
# ########## ## ########## # #
# ########## ## ########## # #
#                            #
##############################
